XXXXXX
XXOO X
XXXB X
X  P X
X   XX
X   XX
XXXXXX