XXXXXX
XXOO X
XXXB X
X B  X
X B XX
XP  XX
XXXXXX