XXXXXX
XXOO X
XXX  X
X B  X
X B XX
XP  XX
XXXXXX